11111111111111111111111111111111
10000000000000000000000000000001
10aaa000000000000000000000000001
10000000000000000000000000000001
10bbb000000000000000000000000001
10000000000000000000000000000001
10ccc000000000000000000000000001
10000000000000000000000000000001
10ddd000000000000000000000000001
10000000000000000000000000000001
10eee000000000000000000000000001
10000000000000000000000000000001
10fff000000000000000000000000001
10000000000000000000000000000001
10ggg000000000000000000000000001
10000000000000000000000000000001
10hhh000000000000000000000000001
10000000000000000000000000000001
10iii000000000000000000000000001
10000000000000000000000000000001
10jjj000000000000000000000000001
10000000000000000000000000000001
10kkk000000000000000000000000001
10000000000000000000000000000001
10lll000000000000000000000000001
10000000000000000000000000000001
10mmm000000000000000000000000001
10000000000000000000000000000001
10nnn000000000000000000000000001
10000000000000000000000000000001
10ooo000000000000000000000000001
11111111111111111111111111111111
