11111111111111111111111111111111
10000000000000010000000000000001
1aaa000000000001iii0000000000001
10000000000000000000000000000001
1bbb000000000001jjj0000000000001
10000000000000010000000000000001
1ccc000000000001kkk0000000000001
10000000000000010000000000000001
1ddd000000000001lll0000000000001
10000000000000010000000000000001
10000000000000010000000000000001
10000000000000010000000000000001
10000000000000000000000000000001
10000000000000010000000000000001
10000000000000010000000000000001
11101111111101111101111111110111
1eee000000000001mmm0000000000001
10000000000000010000000000000001
1fff000000000000nnn0000000000001
10000000000000010000000000000001
1ggg000000000001ooo0000000000001
10000000000000010000000000000001
1hhh000000000001ppp0000000000001
10000000000000010000000000000001
10000000000000010000000000000001
10000000000000010000000000000001
10000000000000010000000000000001
10000000000000010000000000000001
10000000000000000000000000000001
10000000000000010000000000000001
10000000000000010000000000000001
11111111111111111111111111111111
