11111111111111111111111111111111
1kkk0000000000000000000000000001
10000000000000000000000000000001
1lll0000000000000000000000000001
10000000000000000000000000000001
1mmm0000000000000000000000000001
11111111111111111111111111100111
1iii0000000000000000000000000001
10000000000000000000000000000001
1jjj0000000000000000000000000001
10000000000000000000000000000001
10000nnn000000000000000000000001
11100111111111111111111111111111
1fff0000000000000000000000000001
10000000000000000000000000000001
1ggg0000000000000000000000000001
10000000000000000000000000000001
1hhh0000000000000000000000000001
11111111111111111111111111100111
1ddd0000000000000000000000000001
10000000000000000000000000000001
1eee0000000000000000000000000001
10000000000000000000000000000001
10000ooo000000000000000000000001
11100111111111111111111111111111
1aaa0000000000000000000000000001
10000000000000000000000000000001
1bbb0000000000000000000000000001
10000000000000000000000000000001
1ccc0000000000000000000000000001
10000000000000000000000000000001
11111111111111111111111111111111
