11111111111111111111111111000111
10000000000000100000000000000001
00000000000000100000000000000000
10000000000000100000000000000001
11111101111111111111111111111111
10000000000000010000000000000001
00000000000000010000000000000000
10000000000000010000000000000001
11111111111111111111111101111111
10000000000000010000000000000001
10000000000000010000000000000001
10000000000000010000000000000001
10000000000000010000000000000001
10000000000000010000000000000001
00000000000000010000000000000000
10000000000000010000000000000001
10000000000000010000000000000001
11101111111101111111111111111111
1aaa0000000000000eee000000000001
10000000000000000000000000000001
1bbb0000000000000fff000000000001
10000000000000000000000000000001
1ccc0000000000000ggg000000000001
10000000000000000000000000000001
1ddd0000000000000hhh000000000001
10000000000000000000000000000001
10000000010001001100100000000001
10000000011011010010000000000001
10000000010101011110100000000001
10000000010001010010100000000001
1iii0000000000000jjj000000000001
11111111111111111111111111000111
