a0000000100000010000000010000000
aa000000000100000000000000001000
b0000000000000001000000001000000
bb000001000000000000010000000000
c0000000000000100000000001000000
cc000000010000000000000000000100
d0000000000000010000000000010000
dd000001000000000000010000000000
e0000000000100000010000000000000
ee000000000000010000000001000000
f0000000001000000010000000000000
ff000000100000000000000000000100
g0000000001000000000000010000000
gg000000000001000000000000000100
h1000000010000000000000000000000
hh000000000010000000000100000000
i0000010000000000001000000000000
ii000000000000100000000000001000
j0100000000000000000100000000000
jj000000000010000000000000001000
k0000001000000000000010000000000
kk000000000010000000000000001000
l0000000000000000100000001000000
ll000000000100000000000000001000
m0010000000000000100000000000000
mm000000000010000000000010000000
n0000001000000000000000000001000
nn000000000000100000000100000000
o0000000010000000000000000001000
oo000000000001000000000000100000
p0000000000000000001000000000100
pp000000000010000000000010000000
